1111111
1010011
11C0001
1E1P001
1111111