1111111
1000001
100P001
1E000C1
1111111