1111111
1010001
1110111
1E0P0C1
1111111